WE ./Path_xpm/west.xpm 
SO ./Path_xpm/sount.xpm
NO ./Path_xpm/north.xpm
EA ./Path_xpm/east.xpm
        F 10,4,1
        C 1,3,4
1111111111111111111111111
101000000110000000000001
1011001111111111011111111
101100110111000000000001
1011101111111111011111111111111111
1000000000000          01000000001
1111111110110000011100001111111111
100000000011000001110111111111111
11010111111111011100000010001
11110111111111011101010010001
11000000110101011100000010001
10000000000000001100000010001
10000000000000001101010010001
11000001110101011111011110N0111
111101111110101101111010001
111111111111111111111111111
