WE ./Path_xpm/west.xpm 
SO ./Path_xpm/sount.xpm
NO ./Path_xpm/north.xpm
EA ./Path_xpm/east.xpm
        F 10,4,1
        C 1,3,4
        1111111111111111111111111
        1000000000110000000000001
        101100000111000000000001
        100100000   0000000000000001
111111111011000001110000000000001
100000000011000001110111111111111
11010111111111011100000010001
11110111111111011101010010001
 11000000110101011100000010001
 10000000000000001100000010001
 10000000000000001101010010001
 11000001110101011111011110N0111
11110111 1110101 101111010001
11111111 1111111 111111111111
