WE ./Path_xpm/west.xpm
SO ./Path_xpm/west.xpm
NO ./Path_xpm/west.xpm
EA ./Path_xpm/west.xpm
        F 128,128,128
        C 0,0,0

111111111111111111111111
1100000000000000011111111111111111
11111100111111111111
1011000000000000001
1011101111111111011111111111111111  
1000000000000010000000011
1111111110110000011100001111111111
10000000001100001110111111111111
11010111111111011100000010001
1111011111111101 101010010N01
1100000011010101110000100011
1000000000000000110000111011
10000000000000001101010010001
110000011101110111110111100111
1111011111101011011101000111
111111111111111111111111111
