WE ./Path_xpm/west.xpm
SO ./Path_xpm/sount.xpm
NO ./Path_xpm/north.xpm
EA ./Path_xpm/east.xpm
        F 10,4,1
        c 1,3,4

111111111111111111111111
11000000000000000011111111111111111
111111111111111111
1011000000000000001
1011101111111111011111111111111111  
100000000000001000000001
1111111110110000011100001111111111
100000000011000001110111111111111
11010111111111011100000010001
1111011111111101 101010010001
1100000011010101110000010001
100000000000000011N000010101
10000000000000001101010010001
110000011101010111110111100111
11110111111010110111010001
111111111111111111111111111
